
wwwwwwwwwwwwwwwwwwww
w    e  w w  w  e  w
www     w          w
w        e ww w  ww 
w   ~~~~  ww   ~w  w
w      w   ~~~~~~ ww
w      w e      w ww
w  ~~~~~  w        w
w   p        w ~~~~~
w~~~~~~~~          w
w    e       ww wwww
w   www     www    w
w    w        w  e w
w     p            w
wwwwwwwwwwwwwwwwwwww
