
wwwwwwwwwwwwwwwwwwww
w    e  w w  w  e  w
www     w e        w
w         ww w  ww w
w   ~~~~  ww   ~w  w
w      w   ~~~~~~ ww
w      w e      w ww
w  ~~~~~~~~~~~  w
w           w  www w
w~~~~~~~~~  w      w
w           www wwww
w   www     www    w
    w        w     
w     p    p       w
wwwwwwwwwwwwwwwwwwww
